11111111111111111111111111111111111111
10000000000000000000000000000000000C01
10E00000000001111111011111111111111101
10000000001111111100011110001111111101
100000001111111P0000011100001111111101
10000111111110000000010000001111111001
10011111110000000000000001111111100001
10111111000000000000000111111100000001
10111100000000000000011111110000000001
10111111111111111111011111110000011101
10111111111111111111011111110001111101
10111111111111111111011111110111111101
10000000000001111111000000000000000001
10000000000001111111011000000000000001
10000000000001111111011111111111110001
10000000000001111111000000000000000001
11111111111111111111111111111111111111